  "111111111111111111111111",
  "100000000000000000000001",
  "100001111111000110000001",
  "100000000000000000000001",
  "100000100000000111110001",
  "100000100010000000000001",
  "100000000010000000000001",
  "100000100010000000000001",
  "100000100011100000000001",
  "1000001000100000p0000001",
  "100000000010000000000001",
  "100000100010000111110001",
  "100000100010000000000001",
  "100000100010000000000001",
  "100000100010000011110001",
  "100000100010000000000001",
  "100000100010001111000001",
  "100000000000000000000001",
  "111111111111111111111111",