









  "111111111111111111111111"
  "100000000000000000000000001"
  "111000001111111111111111"
  "10000000011111"
  "10000010000p000111110001"
  "100000100010000000000001"
  "100000000010000000000001"
  "100000100010000000000001"
  "100000100011100000000001"
  "1000001000100000p0000001"
  "100000000010000000000001"
  "100000100010000111110001"
  "100000100010000000000001"
  "100000100010000000000001"
  "100000100010000011110001"
  "100000100010000000000001"
  "100000100010001111000001"
  "100000000000000000000001"
  "111111111111111111111111"



        1111111111111111111111111
        1000000000110000000000001
        1011000001110000000000001
        1001000000000000000000001
111111111n11000001110000000000001
111111111111111111111111111111111                                                                                                                    
11111111111111011100000010001
11110111111111011101010010001
11000000110101011100000010001
10000000000000001100000010001
10000000000000001101010010001
1100000110101011111011110N0111
11110111 1110101 101111010001
11111111 1111111 111111111111