NO   texture/path_to_the_north_texture.xpm
SO   texture/path_to_the_south_texture.xpm
WE   texture/path_to_the_west_texture.xpm
EA  texture/path_to_the_east_texture.xpm




C 0, 0, 255   
F 173,216,230

1111111111111111111111111
1111100000001111111000001
1111100111001111100110001
1000001111011100000001111
1111111111111111111111111
     11   111111111111111111111111111

111111111111111111111111111
1111100111N0000011111000011
111000011100010000111100001
111111111111111111111111111
