NO   texture/path_to_the_north_texture.xpm
SO   texture/path_to_the_south_texture.xpm
WE   texture/path_to_the_west_texture.xpm
EA  texture/path_to_the_east_texture.xpm

F 173,216,230
C 0, 0, 255    


        11111111111111111111111111111111111111111111111111111111111111111111111111111111111111111111111111111111111111111111
        10000000001100000000000011111111111111111111111111111111111111111111111111111111111111111111111111111111111111111111
        1011000001110000000N000011111111111111111111111111111111111111111111111111111111111111111111111111111111111111111111
        10010000000000000000000011111111111111111111111111111111111111111111111111111111111111111111111
11111111101100000111000000000000111111111111111111111111111111111111111111111111111111111111
100000000011000001110111111011111111111111111111                     1111111111111111111111111111111111111111111111111111111111111111111111
111101111111110111000000100011111111111111111111                    11111111111111111111111111111111111111111111111111111111111111
1111011111111101110101001000111111111111111111111111111111111111   11111111111111111111111111111111111111111111111111111111
111111111111110111111111111011111111111111111111111111111111111   111111111111111111111111111111111111111111111111111111111
           111011111111111101111111111111111111111111111111111   11111111111111111111111111111111111
           1110111111111111011111111111111111111111111111111   111111111111111111111111111111111111
           1110111111111111011111111111111111111111111111111   1111111111111111111111111111111111111
11111111111111011111111111101111111111111111111111111111111   111111111111111111111111111111111111111111111111
1100000011010100000000001000111111111111111111111111111111   11111111111111111111111111111111111111111111111111
100000000000000011000000000011111111111111111111111111111   111111111111111111111111111111111111111111111111
10000000000000001101010010001111111111111111111111111111   1111111111111111111111111111111111111111111111111
1100000111010101111101111010111111111111111111111111111   11111111111111111111111111111111111111111111111111111
11110111 1110101 1011110100011111111111111111111111111   111111111111111111111111111111111111111111111111111
11111111 1111111 11111111111111111111111111111111111111111111111111111111111111111111111111111111111111111111