F 173,     216,    230

NO   texture/path_to_the_north_texture.xpm
SO   texture/path_to_the_south_texture.xpm
WE   texture/path_to_the_west_texture.xpm
EA  texture/path_to_the_east_texture.xpm



C 0, 105,     12




11111111111111111111111111111111111111111
10000000000000000000000000000000000000001
10000000000000000000000000000000000000001
100000N0000000000000000000000000000000001
10000000000000000000000000000000000000001
10000000000000000000000000000000000000001
10000000000000000000000000000000000000001
11111111111111111111111111111111111111111